10 10
9 9 9 9 9 9 9 9 9 9
9 1 9 7 1 1 1 9 1 9
9 1 1 9 9 9 1 9 1 9
9 9 1 9 1 9 1 1 1 9
9 1 1 9 1 9 9 9 1 9
9 1 9 1 1 9 1 1 1 9
9 1 1 1 9 9 1 9 9 9
9 9 1 9 9 9 1 9 1 9
9 1 1 1 1 3 1 1 1 9
9 9 9 9 9 9 9 9 9 9